0 0 0 0 0 0 0 0 0 0 0 0 0 0 0 0 0 0
0 0 0 0 0 0 0 0 0 0 0 0 0 0 0 0 0 0
0 0 1 2 2 2 3 0 0 1 0 1 1 1 0 0 0 0
0 0 4 5 5 5 12 2 2 3 0 1 1 1 0 0 0 0
0 0 4 5 5 5 5 5 5 6 0 1 1 1 0 0 0 0
0 0 4 5 5 5 10 8 8 13 0 1 1 1 0 0 0 0
0 0 4 5 5 5 6 0 0 1 0 1 0 1 0 0 0 0
0 0 7 8 8 8 9 0 0 1 0 0 1 1 0 0 0 0
0 0 1 0 0 0 0 0 0 1 0 1 0 1 0 0 0 0
0 0 1 1 0 0 0 0 0 1 0 1 1 1 0 0 0 0
0 0 1 1 0 0 0 0 0 1 0 1 1 1 0 0 0 0