0  0  0  0  30 31 0  0  0  0  0  0  0  0  0  0  0  0  0  14 16 0  0  0  0  0  0  1  2  2  2  2  2  2  2  2  2  2  2  2  42 41 15 0  0  0  0  0  0  0  0  0  0  0  0  17 25 2  2  2  2  2  3  
0  0  0  0  0  32 31 0  0  0  0  0  0  0  0  0  0  0  0  17 19 0  0  0  0  0  0  7  12 5  5  5  5  5  5  5  5  5  5  5  6  0  0  0  0  0  0  0  0  0  0  0  0  0  0  0  4  5  5  5  5  5  6  
0  0  0  0  0  0  32 31 0  0  0  0  0  0  0  0  0  0  0  17 19 0  0  0  0  0  0  0  7  8  12 5  5  5  5  5  5  5  5  5  6  0  0  0  0  0  0  0  0  0  0  0  0  0  0  0  4  5  5  5  5  5  6  
0  0  0  0  0  0  0  32 31 0  0  0  0  0  0  0  0  0  0  17 19 0  0  0  0  0  0  0  0  0  7  12 5  5  5  5  5  5  5  5  11 2  3  0  0  0  29 0  0  0  0  0  0  0  0  17 44 12 5  5  5  5  6  
0  0  0  0  0  0  0  0  53 0  0  0  0  0  0  0  0  0  0  17 19 0  0  0  0  0  0  0  0  0  0  7  12 5  5  5  5  5  5  5  5  13 9  0  0  30 34 0  0  0  0  0  0  0  0  0  0  7  12 5  5  5  6  
0  0  0  0  0  33 54 54 39 54 31 0  0  0  0  0  0  0  0  17 19 0  0  0  0  0  0  0  0  0  0  0  7  8  8  8  12 5  5  5  5  6  0  29 0  0  0  0  0  30 31 0  0  0  0  0  0  0  4  5  5  5  6  
30 54 54 54 54 34 0  0  0  0  32 54 54 38 15 15 15 15 55 57 35 54 54 31 0  0  0  0  0  0  0  0  0  0  0  0  7  8  8  8  8  9  0  27 0  0  0  0  0  0  42 54 28 0  0  0  0  1  10 5  5  5  6  
0  0  0  0  0  0  0  0  0  0  0  0  0  20 21 25 26 21 22 0  0  0  0  32 31 0  0  0  0  0  0  0  0  0  0  0  29 0  0  0  0  0  52 0  0  0  29 0  0  30 34 0  0  0  0  1  2  10 5  5  5  5  6  
0  0  0  0  0  0  0  0  0  0  0  0  0  0  0  20 22 0  0  0  0  0  0  0  53 0  0  0  0  0  29 0  52 0  0  0  27 0  0  0  0  0  0  0  0  0  32 31 0  0  0  30 31 0  0  4  5  5  5  5  5  5  6  
0  0  0  0  0  0  0  0  0  0  0  0  1  2  3  0  0  0  0  0  0  0  0  0  32 31 0  0  0  0  27 0  0  0  0  52 0  52 0  0  0  0  0  0  0  0  0  32 28 0  0  0  53 0  0  7  8  8  8  8  8  12 6  
0  0  0  0  0  0  0  0  0  0  0  1  10 13 9  0  0  0  0  0  0  0  0  0  0  58 16 0  0  0  0  0  0  0  0  0  52 0  0  0  0  0  140 141 153 154 0  0  0  0  0  0  32 28 0  0  52 0  0  0  0  4  6  
0  0  0  1  3  0  0  0  0  0  17 31 5  6  0  0  0  0  120 121 121 122 0  0  0  20 35 54 41 54 28 0  0  0  0  0  0  0  0  0  0  152 144 145 0  0  0  0  0  0  0  0  0  0  0  0  171 0  0  0  17 44 9  
0  0  1  10 11 3  0  0  0  0  0  7  8  9  0  0  0  0  126 127 127 127 134 0  0  0  0  0  27 152 153 141 141 141 142 30 28 0  0  0  0  0  146 147 153 153 153 154 0  0  0  0  0  0  172 161 165 0  0  0  0  0  0  
0  0  7  8  8  9  0  0  0  0  0  0  0  0  0  0  120 122 0  0  0  0  0  0  0  0  0  0  0  0  52 143 144 144 144 141 142 30 28 0  0  0  0  0  0  0  0  0  160 161 161 162 0  175 0  163 164 162 0  0  0  0  0  
0  0  0  0  0  0  0  0  0  0  0  0  0  0  0  132 127 128 0  131 0  0  132 121 121 134 0  0  0  0  0  143 144 144 144 144 144 141 141 141 141 141 142 30 28 0  0  172 167 164 164 164 174 0  0  166 167 164 161 174 0  0  0  
0  0  0  0  0  0  0  0  0  0  0  1  2  42 15 0  0  0  120 124 134 0  0  126 128 29 0  0  0  33 28 143 144 144 144 144 147 147 147 147 147 144 145 0  0  0  0  0  0  166 167 168 0  0  0  0  0  166 168 0  0  0  39 
0  0  0  1  3  0  0  0  0  0  17 31 5  6  0  0  0  132 127 128 0  0  0  0  0  32 54 54 38 36 152 147 144 144 144 145 52 0  0  0  0  146 147 153 153 153 154 0  0  0  0  0  171 0  171 0  175 0  0  0  0  0  0  
0  0  1  10 11 3  0  0  0  0  0  7  8  9  0  0  0  0  0  0  0  132 134 0  0  0  0  0  20 35 31 0  146 147 147 147 153 154 0  0  0  0  0  0  0  0  0  0  0  0  0  0  169 0  166 174 0  175 0  0  0  0  0  
0  0  7  8  8  9  0  0  0  0  0  0  0  0  0  0  0  0  0  0  0  0  0  0  0  0  0  0  0  0  32 54 54 54 28 0  0  0  0  0  0  0  0  0  0  0  0  0  0  0  0  0  0  0  0  0  0  0  0  0  17 15 0  
0  0  0  0  0  0  0  0  0  0  0  0  0  0  0  0  0  0  0  0  0  0  0  0  0  0  0  0  0  0  0  0  0  0  0  0  0  0  0  0  0  0  0  0  0  0  0  0  0  0  0  0  0  0  0  0  0  0  0  0  0  0  0  
